0000000000000000000000000000000000000000000000000000000000000000000
000001111110100000000000000000000000000000000000000000000000000E000
0000010000101000000000000000000000000000000000000000000000000000000
0000010S00101000000100000000000000000000000000000000000000000000000
0000010000101000000100000000000000000000000000000000000000000000000
0000010000101000000100000000000000000000000000000000000000000000000
0000010000101000000100000000000000000000000000000000000000000000000
0000010000101000000100000000000000000000000000000000000000000000000
0000010000101000000100000000000000000000000000000000000000000000000
0000010000101000000100000000000000000000000000000000000000000000000
0000010000101000000100000000000000000000000000000000000000000000000
0000010000101T0T0T0100000000000000000000000000000000000000000000000
0000010000101000000100000000000000000000000000000000000000000000000
0000010000101000000100000000000000000000000000000000000000000000000
0000010000101000000100000000000000000000000000000000000000000000000
0000010000101000000100000000000000000000000000000000000000000000000
0000010000101000000100000000000000000000000000000000000000000000000
0000010000101T0T0T0100000000000000000000000000000000000000000000000
0000010000101000000100000000000000000000000000000000000000000000000
0000010000101000000100000000000000000000000000000000000000000000000
0000010000101000000100000000000000000000000000000000000000000000000
0000010000101000000100000000000000000000000000000000000000000000000
0000010000101000000100000000000000000000000000000000000000000000000
0000010000101T0T0T0100000000000000000000000000000000000000000000000
0000010000101000000100000000000000000000000000000000000000000000000
0000010000101000000100000000000000000000000000000000000000000000000
0000010000101000000100000000000000000000000000000000000000000000000
0000010000101O000O0100000000000000000000000000000000000000000000000
0000010000101000000100000000000000000000000000000000000000000000000
0000010000111T0T0T0100000000000000000000000000000000000000000000000
0000010000000000000100000000000000000000000000000000000000000000000
0000010000111000000100000000000000000000000000000000000000000000000
0000010000101000000100000000000000000000000000000000000000000000000
0000010000101000000100000000000000000000000000000000000000000000000
000001000010100O000100000000000000000000000000000000000000000000000
0000010000101000000100000000000000000000000000000000000000000000000
0000010000101O000O0100000000000000000000000000000000000000000000000
000001000010100S000100000000000000000000000000000000000000000000000
0000010000101111001100000000000000000000000000000000000000000000000
0000010000100001001000000000000000000000000000000000000000000000000
0000010000101111001000000000000000000000000000000000000000000000000
0000010000101000001000000000000000000000000000000000000000000000000
0000010000101001111000000000000000000000000000000000000000000000000
0000010000101001000000000000000000000000000000000000000000000000000
0000010000101001111000000000000000000000000000000000000000000000000
0000010000101000001000000000000000000000000000000000000000000000000
0000010000101111001000000000000000000000000000000000000000000000000
0000010000100001001000000000000000000000000000000000000000000000000
0000010000111111001000000000000000000000000000000000000000000000000
0000010000R00000001000000000000000000000000000000000000000000000000
0000010000000000001000000000000000000000000000000000000000000000000
0000011111111111111000000000000000000000000000000000000000000000000
0000000000000000000000000000000000000000000000000000000000000000000