0000000000000000000000000000000000000000000000000000000000000000000
0000000000000000000000000000000000000000000000000000000000000000000
0000000000000000000000000000000000000000000000000000000000000000000
0000000000000000000000000000000000000000000000000000000000000000000
0000000000000000000000000000000000000000000000000000000000000000000
0000000000000000000000000000000000000000000000000000000000000000000
0000000000000000000000000000000000000000000000000000000000000000000
0000000000000000000000000000000000000000000000000000000000000000000
0000000000000000000000000000000000000000000000000000000000000000000
0000000000000001111111111111111111110000000000000000000000000000000
0000000000000001000000000000000000010000000000000000000000000000000
0000000000000001000000000000000000011111111111111111111110000000000
0000000000000001000000000000000000000000000000000000000010000000000
0000000000000001000000000000000000000000000000000000000010000000000
0000000000000001000000001111111111111111111111100000000010000000000
0000000000000001000000001000000000000000000000100000000010000000000
0000000000000001000000001000000000000000000000100000000010000000000
0000000000000001000000001000000000000000000000100000000010000000000
0000000000000001000000001000000000000000000000100000000010000000000
0000000000000001000000001000000000000000000000100000000010000000000
0000000000000001000000001000000000000000000000100000000010000000000
0000000000000001000000001000000000000000000000100000000010000000000
0000000000000001000000001000000000000000000000100000000010000000000
0000000000000001000000001000000000000000000000100000000010000000000
0000000000000001000000001000000000000000000000100000011110000000000
0000000000000001000000001000000000000000000000100000010000000000000
0000000000000001000000001000000000000000000000100000010000000000000
0000000000000001000000001000000000000000000000100000010000000000000
0000000000000001000000001000000000000000000000100000010000000000000
0000000000000001000000001000000000000000000000100000010000000000000
0000000000000001000000001000000000000000000000100000010000000000000
0000000000000001000000001000000000000000000000100000010000000000000
0000000000000001000000001000000000000000000000100000010000000000000
0000000000000001000000001000000000000000000000100000010000000000000
0000000000000001000000001000000000000000000000100000010000000000000
0000000000000001000000001000000000000000000000100000010000000000000
0000000000000001000S000010000000000000000000001000E0010000000000000
0000000000000001111111111000000000000000000000111111110000000000000
0000000000000000000000000000000000000000000000000000000000000000000
0000000000000000000000000000000000000000000000000000000000000000000
0000000000000000000000000000000000000000000000000000000000000000000
0000000000000000000000000000000000000000000000000000000000000000000
0000000000000000000000000000000000000000000000000000000000000000000
0000000000000000000000000000000000000000000000000000000000000000000
0000000000000000000000000000000000000000000000000000000000000000000
0000000000000000000000000000000000000000000000000000000000000000000
0000000000000000000000000000000000000000000000000000000000000000000
0000000000000000000000000000000000000000000000000000000000000000000
0000000000000000000000000000000000000000000000000000000000000000000
0000000000000000000000000000000000000000000000000000000000000000000
0000000000000000000000000000000000000000000000000000000000000000000
0000000000000000000000000000000000000000000000000000000000000000000
0000000000000000000000000000000000000000000000000000000000000000000