0000000000000000000000000000000000000000000000000000000000000000000
0000000000000000000000000000000000000000000000000000000000000000000
0000000000000000000000000000000000000000000000000000000000000000000
0000000000000000000000000000000000000000000000000000000000000000000
0000000000000000000000000000000000000000000000000000000000000000000
0000000000000000000000000000000000000000000000000000000000000000000
0000000000000000000000000000000000000000000000000000000000000000000
0000000000000000000000000000000000000000000000000000000000000000000
0000000000000000000000000000000000000000000000000000000000000000000
0000000000000001111111111111111111111111111111111111111110000000000
0000000000000001000000000000000000000000000000000000000010000000000
0000000000000001000000000000000000000000000000000000000010000000000
0000000000000001000000000000000000000000000000000000000010000000000
0000000000000001000000000000000000000000000000000000000010000000000
0000000000000001000000001111111111111111111111100000000010000000000
0000000000000001000000001000000000000000000000100000000010000000000
0000000000000001000000001000000000000000000000100000000010000000000
0000000000000001000000001000000000000000000000100000000010000000000
0000000000000001000000001000000000000000000000100000000010000000000
0000000000000001000000001000000000000000000000100000000010000000000
0000000000000001000000001000000000000000000000100000000010000000000
0000000000000001000000001000000000000000000000100000000010000000000
0000000000000001000000001000000000000000000000100000000010000000000
0000000000000001000000001000000000000000000000100000000010000000000
0000000000000001000000001000000000000000000000100000001110000000000
0000000000000001000000001000000000000000000000100000001000000000000
0000000000000001000000001000000000000000000000100000001000000000000
0000000000000001000000001000000000000000000000100000001000000000000
0000000000000001000000001000000000000000000000100000001000000000000
0000000000000001000000001000000000000000000000100000001000000000000
0000000000000001000000001000000000000000000000100000001000000000000
0000000000000001000000001000000000000000000000100000001000000000000
0000000000000001000000001000000000000000000000100000001000000000000
0000000000000001000000001000000000000000000000100000001000000000000
0000000000000001000000001000000000000000000000100000001000000000000
0000000000000001000i000010000000000000000000001000f0001000000000000
0000000000000001000000001000000000000000000000100000001000000000000
0000000000000001111111111000000000000000000000111111111000000000000
0000000000000000000000000000000000000000000000000000000000000000000
0000000000000000000000000000000000000000000000000000000000000000000
0000000000000000000000000000000000000000000000000000000000000000000
0000000000000000000000000000000000000000000000000000000000000000000
0000000000000000000000000000000000000000000000000000000000000000000
0000000000000000000000000000000000000000000000000000000000000000000
0000000000000000000000000000000000000000000000000000000000000000000
0000000000000000000000000000000000000000000000000000000000000000000
0000000000000000000000000000000000000000000000000000000000000000000
0000000000000000000000000000000000000000000000000000000000000000000
0000000000000000000000000000000000000000000000000000000000000000000
0000000000000000000000000000000000000000000000000000000000000000000
0000000000000000000000000000000000000000000000000000000000000000000
0000000000000000000000000000000000000000000000000000000000000000000
0000000000000000000000000000000000000000000000000000000000000000000